#1
00000000000000000000
00000000000000000000
00000888888888800000
00000888888888800000
00000888888888800000
00000888888888800000
00000888888888800000
00000888888888800000
00000888888888800000
00000000088000000000
00000000000000000000
00000000000000000000
#2
00000000000000000000
00000000000000000000
00000888888888800000
00000888888888800000
00000888888888800000
00000888888888800000
00000888888888800000
00000888888888800000
00000888888888800000
00000000088000000000
00000000000000000000
00000000000000000000
#3
00000000000000000000
00000000000000000000
00000888888888800000
00000888888888800000
00000888888888800000
00000888888888800000
00000888888888800000
00000888888888800000
00000888888888800000
00000000088000000000
00000000000000000000
00000000000000000000
#4
00000000000000000000
00000000000000000000
00000888888888800000
00000888888888800000
00000888888888800000
00000888888888800000
00000888888888800000
00000888888888800000
00000888888888800000
00000000088000000000
00000000000000000000
00000000000000000000
#5
00000000000000000000
00000000000000000000
00000888888888800000
00000888888888800000
00000888888888800000
00000888888888800000
00000888888888800000
00000888888888800000
00000888888888800000
00000000088000000000
00000000000000000000
00000000000000000000
#6
00000000000000000000
00000000000000000000
00000888888888800000
00000888888888800000
00000888888888800000
00000888888888800000
00000888888888800000
00000888888888800000
00000888888888800000
00000000088000000000
00000000000000000000
00000000000000000000