#1
30303030303030303030
00000000000000000000
30111111111111111111
00111111111111111111
30111111111111111111
00111111111111111111
30111111111111111111
00111111111111111111
30111111111111111111
00111111111111111111
30111111111111111111
00111111111111111111
#2
30707070707070707030
00000000000000000000
30707070l00070707030
00000000000000000000
30707070111170707030
00000000111100000000
30111111111111111130
00111111111111111100
30111111111111111130
00111111111111111100
30303030111130303030
00000000111100000000
#3
30303030303030303030
00000000000000000000
30111111111111111111
00111111111111111111
30111111111111111111
00111111111111111111
30111111111111111111
00111111111111111111
30111111111111111111
00111111111111111111
30111111111111111111
00111111111111111111
#4
30303030303030303030
00000000000000000000
30701111111111111111
00001111111111111111
30112222111400111111
00122222211010111111
30122302211161111701
00122002211161111001
30122222251166666666
00112222111161111111
30111111111161111111
00111111111161111111
#5
30303030111130303030
00000000111100000000
11111111116151111111
11111111116111111111
11111111116111111111
11113011116111111111
11110011706140011111
11111111006101011666
66666666666666666611
11111111111111170611
11111111111111100611
11111122222211111611
#6
30303030303030303030
00000000000000000000
11111111122222222130
11111111222222222200
11301111222222222230
11001117030400307000
11111110000010000030
66666666666666661100
11111111111666111130
11111111111666111100
11111111111666111130
11111111111666111100
#7
30111111111161111111
00111301111161111111
30111001111161111111
00111111111161111111
30111122221166666111
00511112221111116111
11111111111111116111
11111111111400116666
11111111111010116111
11666666666666666111
30303030303030303030
00000000000000000000
#8
11111122222211111611
11111122222211111611
11111122222211111611
11111112221111111611
11111111111111301611
11400111111111001611
11010111151111111611
66666666666666666666
11111111166111111111
11111111166111111111
30303030111130303030
00000000111100000000
#9
11111111111666111130
11223011111666111100
11220011111666111130
11221113011666111100
11111110011666111130
11111400111666111500
11111010111666111111
66666666666666666666
11111111111111170111
11111111111111100111
30303030303030303030
00000000000000000000