#1
30303030303030303030
00000000000000000000
30111111111111111111
00111111111111111111
30111111111111111111
00111111111111111111
30111111111111111111
00111111111111111111
30111111111111111111
00111111111111111111
30111111111111111111
00111111111111111111
#2
30303030303030303030
00000000000000000000
30111111111111111111
00111111222222211111
30112222222222221111
00112222222222222111
30112222222222222301
00112222222222222001
30112222222222221111
00111122222211111111
30111111111111111111
00111111111111111111
#3
30303030111130303030
00000000111100000000
11111130111130111130
11111100111100111100
11111115111111111130
11111111111111111100
11111111111111111130
11111111111113011100
11111111111110011130
11113011111111111100
11110011111111111130
11111111111111111100
#4
30303030303030303030
00000000000000000000
11111111111111111130
11111111111111111100
11111111111111111130
11111111111111111100
11111111111111111130
11111111111111111100
11111111111111111130
11111111111111111100
11111111111111111130
11111111111111111100
#5
30303030303030303030
00000000000000000000
30111111111111111130
00111111111111111100
30111111111111111130
00111111111111111100
30111111111111111130
00111111111111111100
30111111111111111130
00111111111111111100
30303030303030303030
00000000000000000000
#6
30111111111111111111
00111701111111111111
30111001111111111111
00111111130111111111
30111111100111111111
00111111111111111111
30301111111111111111
00001111111113011111
30111111111110011111
00111117011111111111
30111110011111111111
00111111111111111111
#7
11111111111111111130
11117011111301111100
11110011111001111130
11111111111111111100
11111111111112222222
11130111111122222222
11100111111222222222
11111111111122222222
11111111130111222222
11170111100111111222
11100111111111111130
11111111111111111100
#8
11111111111111111130
11111111170111111100
11113011100113011130
11110011111110011100
11111111111111111130
11111111130111111100
11111111100111111130
11130111111111301100
11100111111111001130
11111111301111111100
11111111001111111130
11111111111111111100
#9
30303030303030303030
00000000000000000000
30111111111111111130
00111111111111111100
30111111111111111130
00111111111111111100
30111111111111111130
00111111111111111100
30111111111111111130
00111111111111111100
30303030303030303030
00000000000000000000
#10
30111111111111111111
00111111111111111111
30130111111130111111
00100111111100111111
30111170111111111111
00111100113011111111
30111111110011111111
00111111111111113011
30111301111111110011
00111001111111111111
22112222882222222222
22222222882222222222
#11
11111111111111111130
11111111111111111100
11111111111111301130
11301111111111001100
11001111111111111130
11111113011111111100
11111110011111113030
11170111111111110000
11100111111111111222
11112222222882222222
22222222222882222222
22222222222882222222
#12
30303030303030303030
00000000000000000000
30111111111111111130
00111111111111111100
30111111111111111130
00111111111111111100
30111111111111111130
00111111111111111100
30111111111111111130
00111111111111111100
30303030303030303030
00000000000000000000
#13
30303030303030303030
00000000000000000000
30111111111111111130
00111111111111111100
30111111111111111130
00111111111111111100
30111111111111111130
00111111111111111100
30111111111111111130
00111111111111111100
30303030303030303030
00000000000000000000
#14
22222222882222222222
22222222882222222222
30301111111111111130
00001111111111301100
30111111111111001130
00111111111111111100
30111111111301111130
00111130111001113000
30111100111111110030
00111111111111111100
30303030303030303030
00000000000000000000
#15
22222222222882222222
22211111222882222222
30111111111111111130
00111111111111111100
30111111111111111130
00111111111111111100
30701130400301117030
00001100010501110000
30221111111111112230
00222111111111122200
30222222222222222230
00222222222222222200
#16
30303030303030303030
00000000000000000000
30111111111111111130
00111111111111111100
30111111111111111130
00111111111111111100
30111111111111111130
00111111111111111100
30111111111111111130
00111111111111111100
30303030303030303030
00000000000000000000
00000000000000000000